DXDDDXDDDXDDDXDDDXDD
DDDXDDDXDDDXDDDXDDDX
DDXXXXXXXXXXXXXXXXDD
DDXDDDDDDDDDDDDDDDDX
DDXDXXXXXXXXXXXXDXDD
DDXDXDDDDDDDDDDXDXDD
DDXDXDXXXXXXXXDXDXDD
DDXDXDDDDDDDDDDDDXDD
DDXDXXXXXXXXXXXXDXDD
DDXDDDDDDDDDDDDDDDDX
DDXXXXXXXXXXXXXXXXDD
DDDXDDDXDDDXDDDXDDDX
DXDDDXDDDXDDDXDDDXDD
