DDDDDDDDDDDDDDDDDDDD
D---------D---------D
D-XXXXX-D-D-D-XXXXX-D
D-D-D-D-D-D-D-D-D-D-D
D-D-D-D-D-D-D-D-D-D-D
D-XXXXX-D-D-D-XXXXX-D
D---------D---------D
D-XXXXXXXXXXXXXXXXX-D
D-------------------D
DDDDDDDDDDDDDDDDDDD-D
D-----------------D-D
DDDDDDDDDDDDDDDDD-D-D
D---------------D-D-D
DDDDDDDDDDD-D-D-D-D
D-------------D-D-D-D
DDDDDDDDDD-D-D-D-D-D
D-----------D-D-D-D-D
DDDDDDDDD-D-D-D-D-D-D
D---------D-D-D-D-D-D
DDDDDDDDDDDDDDDDDDDD

