DDDDDDDDDDDDDD
XXXXXXXXXXXXXD
XXXXXXXXXXXXDD
XXXXXXXXXXXXDX
XXXXXXXXXXXDDX
XXXXXXXXXXXDXX
XXXXXXXXXXDDXX
XXXXXXXXXDDXXX
XXXXXXXXXDXXXX
DDDDDDDDDDXXXX